,Provider,Client,Start,End,Hours,Type,Status
1,Provider1,Provider1,1517248800,1517251500,2700,Life Skills,Confirmed (Appt has happened)
2,Provider1,Provider2,1517256000,1517263200,7200,Life Skills,Confirmed (Appt has happened)
3,Provider1,Provider1,1517335200,1517338800,3600,Life Skills,Confirmed (Appt has happened)
4,Provider1,Provider3,1517346000,1517351400,5400,Life Skills,Confirmed (Appt has happened)
5,Provider1,Provider2,1517432400,1517443200,10800,Life Skills,Confirmed (Appt has happened)
6,Provider1,Provider4,1517508000,1517515200,7200,Life Skills,Confirmed (Appt has happened)
7,Provider1,Provider2,1517518800,1517526000,7200,Life Skills,Confirmed (Appt has happened)
8,Provider1,Provider1,1517853600,1517856300,2700,Life Skills,Confirmed (Appt has happened)
9,Provider1,Provider2,1517857200,1517868000,10800,Life Skills,Confirmed (Appt has happened)
10,Provider1,Provider1,1517940000,1517943600,3600,Life Skills,Confirmed (Appt has happened)
11,Provider1,Provider3,1517950800,1517956200,5400,Life Skills,Confirmed (Appt has happened)
12,Provider1,Provider1,1518034500,1518037200,2700,Meeting,Confirmed (Appt has happened)
13,Provider1,Provider2,1518037200,1518048000,10800,Life Skills,Confirmed (Appt has happened)
14,Provider1,Provider4,1518112800,1518120000,7200,Life Skills,Confirmed (Appt has happened)
15,Provider1,Provider2,1518123600,1518130800,7200,Life Skills,Confirmed (Appt has happened)
16,Provider1,Provider1,1518458400,1518461100,2700,Life Skills,Confirmed (Appt has happened)
17,Provider1,Provider2,1518463800,1518472800,9000,Life Skills,Confirmed (Appt has happened)
18,Provider1,Provider1,1518544800,1518548400,3600,Life Skills,Confirmed (Appt has happened)
19,Provider1,Provider3,1518555600,1518561000,5400,Life Skills,Confirmed (Appt has happened)
20,Provider1,Provider2,1518642000,1518652800,10800,Life Skills,Confirmed (Appt has happened)
21,Provider1,Provider4,1518717600,1518724800,7200,Life Skills,Confirmed (Appt has happened)
22,Provider1,Provider2,1518728400,1518735600,7200,Life Skills,Confirmed (Appt has happened)
23,Provider1,Provider1,1519063200,1519065900,2700,Life Skills,Confirmed (Appt has happened)
24,Provider1,Provider2,1519068600,1519077600,9000,Life Skills,Confirmed (Appt has happened)
25,Provider1,Provider1,1519149600,1519153200,3600,Life Skills,Confirmed (Appt has happened)
26,Provider1,Provider3,1519160400,1519165800,5400,Life Skills,Confirmed (Appt has happened)
27,Provider1,Provider1,1519244100,1519246800,2700,Meeting,Confirmed (Appt has happened)
28,Provider1,Provider2,1519246800,1519257600,10800,Life Skills,Confirmed (Appt has happened)
29,Provider1,Provider4,1519322400,1519329600,7200,Life Skills,Confirmed (Appt has happened)
30,Provider1,Provider2,1519333200,1519340400,7200,Life Skills,Confirmed (Appt has happened)
31,Provider1,Provider1,1519668000,1519670700,2700,Life Skills,Confirmed (Appt has happened)
32,Provider1,Provider2,1519673400,1519682400,9000,Life Skills,Confirmed (Appt has happened)
33,Provider1,Provider1,1519754400,1519758000,3600,Life Skills,Confirmed (Appt has happened)
34,Provider1,Provider3,1519765200,1519770600,5400,Life Skills,Confirmed (Appt has happened)
35,Provider1,Provider2,1519851600,1519862400,10800,Life Skills,Confirmed (Appt has happened)
36,Provider1,Provider4,1519927200,1519934400,7200,Life Skills,Confirmed (Appt has happened)
37,Provider1,Provider2,1519938000,1519945200,7200,Life Skills,Confirmed (Appt has happened)
38,Provider2,Provider2,1517265000,1517268600,3600,Meeting with Provider7,Confirmed (Appt has happened)
39,Provider3,Provider5,1517529600,1517533200,3600,Ed. Therapy,Confirmed (Appt has happened)
40,Provider3,Provider5,1518048000,1518051600,3600,Ed. Therapy,Confirmed (Appt has happened)
41,Provider3,Provider5,1519257600,1519261200,3600,Ed. Therapy,Scheduled
42,Provider4,Provider6,1517355000,1517358600,3600,Ed. Therapy,Confirmed (Appt has happened)
43,Provider4,Provider7,1517434200,1517439600,5400,Ed. Therapy,Confirmed (Appt has happened)
44,Provider4,Provider8,1517439600,1517443200,3600,Ed. Therapy,Confirmed (Appt has happened)
45,Provider4,Provider8,1517770800,1517774400,3600,Skype/GotoMeeting Appointment,Confirmed (Appt has happened)
46,Provider4,Provider8,1517884200,1517887800,3600,Skype/GotoMeeting Appointment,Confirmed (Appt has happened)
47,Provider4,Provider6,1517959800,1517963400,3600,Ed. Therapy,Confirmed (Appt has happened)
48,Provider4,Provider7,1518039000,1518044400,5400,Ed. Therapy,Cancelled (w/out 24 hr notice charge)
49,Provider4,Provider8,1518046200,1518049800,3600,Ed. Therapy,Confirmed (Appt has happened)
50,Provider4,Provider6,1518564600,1518568200,3600,Ed. Therapy,Confirmed (Appt has happened)
51,Provider4,Provider7,1518643800,1518649200,5400,Ed. Therapy,Confirmed (Appt has happened)
52,Provider4,Provider8,1518649200,1518652800,3600,Ed. Therapy,Confirmed (Appt has happened)
53,Provider4,Provider8,1519088400,1519092000,3600,Skype/GotoMeeting Appointment,Confirmed (Appt has happened)
54,Provider4,Provider6,1519169400,1519173000,3600,Ed. Therapy,Confirmed (Appt has happened)
55,Provider4,Provider8,1519200000,1519200000,0,Ed. Therapy,
56,Provider4,Provider7,1519248600,1519254000,5400,Ed. Therapy,Confirmed (Appt has happened)
57,Provider5,Provider9,1517355900,1517356800,900,Ed. Therapy,Confirmed (Appt has happened)
58,Provider5,Provider10,1517360400,1517364000,3600,Ed. Therapy,Cancelled (No charge not rescheduled)
59,Provider5,Provider11,1517364900,1517365800,900,Parent Meeting,Confirmed (Appt has happened)
60,Provider5,Provider12,1517365800,1517367600,1800,Parent Meeting,Confirmed (Appt has happened)
61,Provider5,Provider13,1517421600,1517425200,3600,Meeting,Confirmed (Appt has happened)
62,Provider5,Provider12,1517504400,1517511600,7200,Ed. Therapy,Confirmed (Appt has happened)
63,Provider5,Provider14,1517511600,1517515200,3600,Ed. Therapy,Confirmed (Appt has happened)
64,Provider5,Provider12,1517611500,1517616000,4500,Ed. Therapy,Confirmed (Appt has happened)
65,Provider5,Provider12,1517880600,1517882400,1800,Phone Call,Confirmed (Appt has happened)
66,Provider5,Provider10,1517965200,1517968800,3600,Ed. Therapy,Confirmed (Appt has happened)
67,Provider5,Provider13,1518026400,1518040800,14400,Ed. Therapy,Confirmed (Appt has happened)
68,Provider5,Provider14,1518202800,1518206400,3600,Ed. Therapy,Confirmed (Appt has happened)
69,Provider5,Provider12,1518206400,1518210000,3600,Ed. Therapy,Confirmed (Appt has happened)
70,Provider5,Provider15,1518564600,1518568200,3600,Ed. Therapy,Confirmed (Appt has happened)
71,Provider5,Provider10,1518570000,1518573600,3600,Ed. Therapy,Confirmed (Appt has happened)
72,Provider5,Provider13,1518631200,1518645600,14400,Ed. Therapy,Confirmed (Appt has happened)
73,Provider5,Provider16,1518728400,1518730200,1800,Ed. Therapy,Confirmed (Appt has happened)
74,Provider5,Provider11,1518739200,1518742800,3600,Ed. Therapy,Confirmed (Appt has happened)
75,Provider5,Provider14,1518807600,1518811200,3600,Ed. Therapy,Confirmed (Appt has happened)
76,Provider5,Provider12,1518813000,1518816600,3600,Ed. Therapy,Confirmed (Appt has happened)
77,Provider5,Provider12,1519149600,1519153200,3600,Administrative,Confirmed (Appt has happened)
78,Provider5,Provider15,1519169400,1519173000,3600,Ed. Therapy,Confirmed (Appt has happened)
79,Provider5,Provider10,1519174800,1519178400,3600,Ed. Therapy,Confirmed (Appt has happened)
80,Provider5,Provider13,1519236000,1519250400,14400,Ed. Therapy,Confirmed (Appt has happened)
81,Provider5,Provider15,1519774200,1519777800,3600,Ed. Therapy,Confirmed (Appt has happened)
82,Provider5,Provider10,1519779600,1519783200,3600,Ed. Therapy,Confirmed (Appt has happened)
83,Provider5,Provider13,1519840800,1519855200,14400,Ed. Therapy,Confirmed (Appt has happened)
84,Provider5,Provider16,1519938000,1519939800,1800,Ed. Therapy,Confirmed (Appt has happened)
85,Provider6,Provider1,1517251500,1517254200,2700,Ed. Therapy,Confirmed (Appt has happened)
86,Provider6,Provider17,1517254200,1517256000,1800,Administrative,Confirmed (Appt has happened)
87,Provider6,Provider18,1517256000,1517260500,4500,Ed. Therapy,Confirmed (Appt has happened)
88,Provider6,Provider17,1517261400,1517266800,5400,Ed. Therapy,Confirmed (Appt has happened)
89,Provider6,Provider1,1517421600,1517425200,3600,Ed. Therapy,Confirmed (Appt has happened)
90,Provider6,Provider17,1517434200,1517439600,5400,Ed. Therapy,Confirmed (Appt has happened)
91,Provider6,Provider1,1517856300,1517859900,3600,Ed. Therapy,Confirmed (Appt has happened)
92,Provider6,Provider18,1517860800,1517865300,4500,Ed. Therapy,Confirmed (Appt has happened)
93,Provider6,Provider17,1517866200,1517871600,5400,Ed. Therapy,Cancelled (No Charge & rescheduled)
94,Provider6,Provider1,1518026400,1518030000,3600,Ed. Therapy,Confirmed (Appt has happened)
95,Provider6,Provider17,1518030000,1518031800,1800,Administrative,Confirmed (Appt has happened)
96,Provider6,Provider1,1518033600,1518037200,3600,Administrative,Confirmed (Appt has happened)
97,Provider6,Provider17,1518039000,1518044400,5400,Ed. Therapy,Confirmed (Appt has happened)
98,Provider6,Provider1,1518461100,1518463800,2700,Ed. Therapy,Confirmed (Appt has happened)
99,Provider6,Provider17,1518463800,1518465600,1800,Administrative,Confirmed (Appt has happened)
100,Provider6,Provider17,1518471000,1518476400,5400,Ed. Therapy,Confirmed (Appt has happened)
101,Provider6,Provider1,1518631200,1518634800,3600,Ed. Therapy,Confirmed (Appt has happened)
102,Provider6,Provider17,1518643800,1518649200,5400,Ed. Therapy,Confirmed (Appt has happened)
103,Provider6,Provider18,1518649200,1518653700,4500,Ed. Therapy,Confirmed (Appt has happened)
104,Provider6,Provider1,1519065900,1519068600,2700,Ed. Therapy,Cancelled (No charge not rescheduled)
105,Provider6,Provider17,1519075800,1519081200,5400,Ed. Therapy,Cancelled (No charge not rescheduled)
106,Provider6,Provider1,1519236000,1519239600,3600,Ed. Therapy,Scheduled
107,Provider6,Provider1,1519241400,1519246800,5400,Administrative,Cancelled (No Charge & rescheduled)
108,Provider6,Provider18,1519246800,1519250400,3600,Ed. Therapy,Scheduled
109,Provider6,Provider17,1519248600,1519254000,5400,Ed. Therapy,Cancelled (No charge not rescheduled)
110,Provider6,Provider18,1519254000,1519258500,4500,Ed. Therapy,Cancelled (No charge not rescheduled)
111,Provider6,Provider1,1519668000,1519673400,5400,Ed. Therapy,Scheduled
112,Provider6,Provider17,1519673400,1519675200,1800,Administrative,Scheduled
113,Provider6,Provider17,1519680600,1519686000,5400,Ed. Therapy,Scheduled
114,Provider6,Provider1,1519840800,1519844400,3600,Ed. Therapy,Cancelled (No charge not rescheduled)
116,Provider6,Provider17,1519853400,1519858800,5400,Ed. Therapy,Scheduled
117,Provider7,Provider19,1517356800,1517360400,3600,Ed. Therapy,Confirmed (Appt has happened)
118,Provider7,Provider20,1517535000,1517538600,3600,Ed. Therapy,Confirmed (Appt has happened)
119,Provider7,Provider21,1517610600,1517614200,3600,Ed. Therapy,Confirmed (Appt has happened)
120,Provider7,Provider22,1517963400,1517967000,3600,,Confirmed (Appt has happened)
121,Provider7,Provider23,1518112800,1518116400,3600,,Scheduled
122,Provider7,Ari Cohen,1518139800,1518143400,3600,Ed. Therapy,Confirmed (Appt has happened)
123,Provider7,Riley Fisher,1518215400,1518219000,3600,,Confirmed (Appt has happened)
124,Provider7,Provider24,1518715800,1518726600,10800,,
125,Provider7,Jovan Townsley,1518741000,1518744600,3600,,
126,Provider7,Ari Cohen,1518744600,1518748200,3600,Ed. Therapy,Confirmed (Appt has happened)
127,Provider7,Riley Fisher,1518822000,1518823800,1800,,
128,Provider7,Riley Fisher,1518823800,1518827400,3600,,
129,Provider7,Provider25,1519086600,1519090200,3600,,
130,Provider7,Ari Cohen,1519349400,1519353000,3600,Ed. Therapy,Confirmed (Appt has happened)
131,Provider7,Charles Chadwick,1519687800,1519691400,3600,,
132,Provider7,Riley Fisher,1519695000,1519698600,3600,,
133,Provider8,Provider26,1517248800,1517252400,3600,,Confirmed (Appt has happened)
134,Provider8,Provider26,1517252400,1517256000,3600,,Confirmed (Appt has happened)
135,Provider8,Provider27,1517421600,1517425200,3600,,
136,Provider8,Provider28,1517421600,1517425200,3600,,Cancelled (No charge not rescheduled)
137,Provider8,Provider28,1517425200,1517428800,3600,,Cancelled (No charge not rescheduled)
138,Provider8,Provider27,1517425200,1517428800,3600,,
139,Provider8,Provider29,1517853600,1517857200,3600,,Confirmed (Appt has happened)
140,Provider8,Provider29,1517857200,1517860800,3600,,Confirmed (Appt has happened)
141,Provider8,Provider30,1518026400,1518030000,3600,,Confirmed (Appt has happened)
142,Provider8,Provider30,1518030000,1518033600,3600,,Confirmed (Appt has happened)
143,Provider8,Provider30,1518033600,1518035400,1800,,Confirmed (Appt has happened)
144,Provider8,Provider31,1518631200,1518634800,3600,,
145,Provider8,Provider31,1518634800,1518638400,3600,,
146,Provider8,Provider31,1518638400,1518640200,1800,,
148,Provider9,Provider33,1517272200,1517275800,3600,,Confirmed (Appt has happened)
149,Provider9,Joaquin Darbro,1518458400,1518462000,3600,Ed. Therapy,Confirmed (Appt has happened)
150,Provider10,Provider31,1517333400,1517344200,10800,,Confirmed (Appt has happened)
151,Provider10,Provider29,1517355000,1517358600,3600,,
152,Provider10,Provider31,1517506200,1517517000,10800,,
153,Provider10,Provider31,1518111000,1518118200,7200,,
154,Provider10,Provider34,1518647400,1518656400,9000,,Confirmed (Appt has happened)
156,Provider10,Provider35,1520015400,1520026200,10800,,
157,Provider10,Provider35,1520096400,1520110800,14400,,
158,Provider11,Provider36,1517243400,1517247000,3600,Ed. Therapy,Cancelled (No charge not rescheduled)
159,Provider11,Provider37,1517263200,1517266800,3600,Tutoring,Confirmed (Appt has happened)
160,Provider11,Provider38,1517268600,1517272200,3600,Ed. Therapy,Cancelled (No charge not rescheduled)
161,Provider11,Joaquin Darbro,1517274000,1517275800,1800,Ed. Therapy,Confirmed (Appt has happened)
162,Provider11,Provider13,1517335200,1517342400,7200,Ed. Therapy,Cancelled (No charge not rescheduled)
163,Provider11,Provider38,1517349600,1517355000,5400,Ed. Therapy,Cancelled (No charge not rescheduled)
164,Provider11,Provider39,1517356800,1517360400,3600,Ed. Therapy,Cancelled (No charge not rescheduled)
165,Provider11,Provider40,1517360400,1517364000,3600,Ed. Therapy,Cancelled (No charge not rescheduled)
166,Provider11,Provider41,1517443200,1517446800,3600,Ed. Therapy,Cancelled (No charge not rescheduled)
167,Provider11,Provider37,1517446800,1517450400,3600,Tutoring,Cancelled (No charge not rescheduled)
168,Provider11,Provider36,1517504100,1517509500,5400,Ed. Therapy,Cancelled (No charge not rescheduled)
169,Provider11,Provider38,1517522400,1517527800,5400,Ed. Therapy,Cancelled (No charge not rescheduled)
170,Provider11,Provider42,1517531400,1517535000,3600,Ed. Therapy,Cancelled (No charge not rescheduled)
171,Provider11,Provider43,1517535000,1517538600,3600,Ed. Therapy,Cancelled (No charge not rescheduled)
172,Provider11,Provider1,1517594400,1517599800,5400,Ed. Therapy,Confirmed (Appt has happened)
173,Provider11,Provider36,1517601600,1517603400,1800,School Meeting,Confirmed (Appt has happened)
174,Provider11,Provider43,1517616000,1517619600,3600,Ed. Therapy,Confirmed (Appt has happened)
175,Provider11,Provider36,1517848200,1517851800,3600,Ed. Therapy,Cancelled (No charge not rescheduled)
176,Provider11,Joaquin Darbro,1517853600,1517857200,3600,Ed. Therapy,Confirmed (Appt has happened)
177,Provider11,Provider38,1517873400,1517877000,3600,Ed. Therapy,Cancelled (No charge not rescheduled)
178,Provider11,Provider13,1517940000,1517947200,7200,Ed. Therapy,Confirmed (Appt has happened)
179,Provider11,Provider38,1517954400,1517959800,5400,Ed. Therapy,Confirmed (Appt has happened)
180,Provider11,Provider39,1517961600,1517965200,3600,Ed. Therapy,Confirmed (Appt has happened)
181,Provider11,Provider40,1517965200,1517968800,3600,Ed. Therapy,Cancelled (No charge not rescheduled)
182,Provider11,Provider37,1517965200,1517968800,3600,Tutoring,Confirmed (Appt has happened)
183,Provider11,Provider41,1518046200,1518049800,3600,Ed. Therapy,Confirmed (Appt has happened)
184,Provider11,Provider36,1518108900,1518114300,5400,Ed. Therapy,Confirmed (Appt has happened)
185,Provider11,Provider38,1518127200,1518132600,5400,Ed. Therapy,Confirmed (Appt has happened)
186,Provider11,Provider42,1518136200,1518139800,3600,Ed. Therapy,Confirmed (Appt has happened)
187,Provider11,Provider43,1518139800,1518143400,3600,Ed. Therapy,Confirmed (Appt has happened)
188,Provider11,Provider1,1518199200,1518204600,5400,Ed. Therapy,Confirmed (Appt has happened)
189,Provider11,Provider44,1518219000,1518222600,3600,Ed. Therapy,Confirmed (Appt has happened)
190,Provider11,Provider36,1518453000,1518456600,3600,Ed. Therapy,Confirmed (Appt has happened)
191,Provider11,Provider38,1518478200,1518481800,3600,Ed. Therapy,Confirmed (Appt has happened)
192,Provider11,Provider44,1518487200,1518490800,3600,Ed. Therapy,Confirmed (Appt has happened)
193,Provider11,Provider13,1518544800,1518552000,7200,Ed. Therapy,Confirmed (Appt has happened)
194,Provider11,Provider38,1518559200,1518564600,5400,Ed. Therapy,Confirmed (Appt has happened)
195,Provider11,Provider41,1518651000,1518654600,3600,Ed. Therapy,Confirmed (Appt has happened)
196,Provider11,Provider39,1518656400,1518660000,3600,Ed. Therapy,Confirmed (Appt has happened)
197,Provider11,Provider37,1518660000,1518663600,3600,Tutoring,Confirmed (Appt has happened)
198,Provider11,Provider36,1518713700,1518719100,5400,Ed. Therapy,Confirmed (Appt has happened)
199,Provider11,Provider38,1518732000,1518737400,5400,Ed. Therapy,Confirmed (Appt has happened)
200,Provider11,Provider42,1518741000,1518744600,3600,Ed. Therapy,Confirmed (Appt has happened)
201,Provider11,Provider43,1518744600,1518748200,3600,Ed. Therapy,Confirmed (Appt has happened)
202,Provider11,Provider1,1518804000,1518809400,5400,Ed. Therapy,Confirmed (Appt has happened)
203,Provider11,Provider44,1518823800,1518827400,3600,Ed. Therapy,Confirmed (Appt has happened)
204,Provider11,Provider36,1519057800,1519061400,3600,Ed. Therapy,Cancelled (No charge not rescheduled)
205,Provider11,Joaquin Darbro,1519063200,1519066800,3600,Ed. Therapy,Confirmed (Appt has happened)
206,Provider11,Provider38,1519083000,1519086600,3600,Ed. Therapy,Cancelled (No charge not rescheduled)
207,Provider11,Provider44,1519092000,1519095600,3600,Ed. Therapy,Scheduled
208,Provider11,Provider13,1519149600,1519156800,7200,Ed. Therapy,Scheduled
209,Provider11,Provider38,1519164000,1519169400,5400,Ed. Therapy,Scheduled
210,Provider11,Provider39,1519171200,1519174800,3600,Ed. Therapy,Scheduled
211,Provider11,Provider1,1519241400,1519246800,5400,Meeting,Scheduled
212,Provider11,Provider41,1519257600,1519261200,3600,Ed. Therapy,Scheduled
213,Provider11,Provider39,1519261200,1519264800,3600,Ed. Therapy,Scheduled
214,Provider11,Provider37,1519264800,1519268400,3600,Tutoring,Scheduled
215,Provider11,Provider36,1519318500,1519323900,5400,Ed. Therapy,Scheduled
216,Provider11,Provider38,1519336800,1519342200,5400,Ed. Therapy,Scheduled
217,Provider11,Provider42,1519345800,1519349400,3600,Ed. Therapy,Scheduled
218,Provider11,Provider43,1519349400,1519353000,3600,Ed. Therapy,Scheduled
219,Provider11,Provider1,1519408800,1519414200,5400,Ed. Therapy,Scheduled
220,Provider11,Provider45,1519416000,1519428600,12600,Ed. Therapy,Scheduled
221,Provider11,Provider44,1519428600,1519432200,3600,Ed. Therapy,Scheduled
222,Provider11,Provider45,1519682400,1519686000,3600,Ed. Therapy,Scheduled
223,Provider11,Provider38,1519687800,1519691400,3600,Ed. Therapy,Confirmed (Appt has happened)
224,Provider11,Provider45,1519693200,1519696800,3600,Ed. Therapy,Scheduled
225,Provider11,Provider41,1519862400,1519866000,3600,Ed. Therapy,Scheduled
226,Provider11,Provider42,1519950600,1519954200,3600,Ed. Therapy,Scheduled
227,Provider11,Provider43,1519954200,1519957800,3600,Ed. Therapy,Scheduled
228,Provider11,Provider1,1520013600,1520019000,5400,Ed. Therapy,Scheduled
229,Provider11,Provider42,1520123400,1520127000,3600,Ed. Therapy,Scheduled
230,Provider11,Provider43,1520127000,1520130600,3600,Ed. Therapy,Scheduled
231,Provider12,Provider46,1517360400,1517364000,3600,Ed. Therapy,
232,Provider12,Provider47,1517953500,1517957100,3600,Ed. Therapy,Confirmed (Appt has happened)
233,Provider12,Provider34,1517961600,1517965200,3600,Ed. Therapy,Confirmed (Appt has happened)
234,Provider12,Provider48,1518037200,1518040800,3600,Ed. Therapy,Confirmed (Appt has happened)
235,Provider12,Provider34,1518566400,1518570000,3600,Ed. Therapy,Confirmed (Appt has happened)
236,Provider12,Provider34,1519171200,1519174800,3600,Ed. Therapy,Scheduled
237,Provider13,Provider49,1517351400,1517355000,3600,Intake,Confirmed (Appt has happened)
238,Provider13,Provider50,1517356800,1517360400,3600,Ed. Therapy,Confirmed (Appt has happened)
239,Provider13,Provider51,1517362200,1517365800,3600,Assessment,Confirmed (Appt has happened)
240,Provider13,Zachary Shaw,1517432400,1517436000,3600,,Cancelled (No Charge & rescheduled)
241,Provider13,Provider50,1517441400,1517445000,3600,Ed. Therapy,Confirmed (Appt has happened)
242,Provider13,Provider52,1517445000,1517448600,3600,Ed. Therapy,Confirmed (Appt has happened)
243,Provider13,Provider53,1517518800,1517522400,3600,Ed. Therapy,Confirmed (Appt has happened)
244,Provider13,Provider54,1517527800,1517531400,3600,Ed. Therapy,Confirmed (Appt has happened)
245,Provider13,Provider55,1517531400,1517535000,3600,Ed. Therapy,Confirmed (Appt has happened)
246,Provider13,Provider51,1517535000,1517538600,3600,Ed. Therapy,Confirmed (Appt has happened)
247,Provider13,Provider50,1517961600,1517965200,3600,Ed. Therapy,Confirmed (Appt has happened)
248,Provider13,Provider51,1517967000,1517970600,3600,,Confirmed (Appt has happened)
249,Provider13,Provider50,1518046200,1518049800,3600,Ed. Therapy,Confirmed (Appt has happened)
250,Provider13,Provider52,1518049800,1518053400,3600,Ed. Therapy,Confirmed (Appt has happened)
251,Provider13,Provider56,1518053400,1518057000,3600,Intake,Confirmed (Appt has happened)
252,Provider13,Provider53,1518116400,1518120000,3600,Ed. Therapy,Confirmed (Appt has happened)
253,Provider13,Provider54,1518132600,1518136200,3600,Ed. Therapy,Confirmed (Appt has happened)
254,Provider13,Provider55,1518136200,1518139800,3600,Ed. Therapy,Confirmed (Appt has happened)
255,Provider13,Provider51,1518139800,1518143400,3600,Ed. Therapy,Confirmed (Appt has happened)
256,Provider13,Provider50,1518568200,1518571800,3600,Ed. Therapy,Confirmed (Appt has happened)
257,Provider13,Provider51,1518571800,1518575400,3600,Ed. Therapy,Confirmed (Appt has happened)
258,Provider13,Provider52,1518634800,1518636600,1800,Parent Meeting,Confirmed (Appt has happened)
259,Provider13,Provider57,1518647400,1518651000,3600,,Cancelled (No charge not rescheduled)
260,Provider13,Provider50,1518651000,1518654600,3600,Ed. Therapy,Confirmed (Appt has happened)
261,Provider13,Provider52,1518654600,1518658200,3600,Ed. Therapy,Confirmed (Appt has happened)
262,Provider13,Provider53,1518732000,1518735600,3600,Ed. Therapy,Confirmed (Appt has happened)
263,Provider13,Provider54,1518737400,1518741000,3600,Ed. Therapy,Confirmed (Appt has happened)
264,Provider13,Provider55,1518741000,1518744600,3600,Ed. Therapy,Confirmed (Appt has happened)
265,Provider13,Provider50,1519173000,1519176600,3600,Ed. Therapy,Scheduled
266,Provider13,Provider51,1519176600,1519180200,3600,Ed. Therapy,Scheduled
267,Provider13,Provider50,1519255800,1519259400,3600,Ed. Therapy,Scheduled
268,Provider13,Provider52,1519259400,1519263000,3600,Ed. Therapy,Scheduled
269,Provider13,Provider53,1519326000,1519329600,3600,Ed. Therapy,Scheduled
270,Provider13,Provider54,1519342200,1519345800,3600,Ed. Therapy,Confirmed (Appt has happened)
271,Provider13,Provider55,1519345800,1519349400,3600,Ed. Therapy,Confirmed (Appt has happened)
272,Provider13,Provider51,1519349400,1519353000,3600,Ed. Therapy,Scheduled
273,Provider13,Provider50,1519776000,1519779600,3600,Ed. Therapy,Confirmed (Appt has happened)
274,Provider13,Provider51,1519781400,1519785000,3600,,Confirmed (Appt has happened)
275,Provider13,Provider50,1519860600,1519864200,3600,Ed. Therapy,Scheduled
276,Provider13,Provider52,1519864200,1519867800,3600,Ed. Therapy,Scheduled
277,Provider14,Provider2,1517263200,1517270400,7200,Tutoring,Confirmed (Appt has happened)
278,Provider14,Provider7,1517270400,1517275800,5400,Tutoring,Confirmed (Appt has happened)
279,Provider14,Provider1,1517338800,1517340600,1800,Tutoring,Confirmed (Appt has happened)
280,Provider14,Provider1,1517508000,1517513400,5400,Tutoring,Confirmed (Appt has happened)
281,Provider14,Provider7,1517535000,1517538600,3600,Tutoring,Confirmed (Appt has happened)
282,Provider14,Provider2,1517868000,1517875200,7200,Tutoring,Confirmed (Appt has happened)
283,Provider14,Provider1,1517943600,1517945400,1800,Tutoring,Confirmed (Appt has happened)
284,Provider14,Provider1,1517945400,1517946300,900,Administrative,Confirmed (Appt has happened)
285,Provider14,Provider1,1518033600,1518037200,3600,Administrative,Confirmed (Appt has happened)
286,Provider14,Provider1,1518112800,1518118200,5400,Tutoring,Confirmed (Appt has happened)
287,Provider14,Provider2,1518472800,1518480000,7200,Tutoring,Confirmed (Appt has happened)
288,Provider14,Provider7,1518480000,1518485400,5400,Tutoring,Confirmed (Appt has happened)
289,Provider14,Provider1,1518548400,1518550200,1800,Tutoring,Confirmed (Appt has happened)
290,Provider14,Provider1,1518717600,1518723000,5400,Tutoring,Confirmed (Appt has happened)
291,Provider14,Provider7,1518742800,1518746400,3600,Tutoring,Confirmed (Appt has happened)
292,Provider14,Provider2,1519077600,1519084800,7200,Tutoring,Confirmed (Appt has happened)
293,Provider14,Provider1,1519153200,1519155000,1800,Tutoring,Confirmed (Appt has happened)
294,Provider14,Provider1,1519243200,1519245900,2700,Administrative,Confirmed (Appt has happened)
295,Provider14,Provider1,1519322400,1519327800,5400,Tutoring,Confirmed (Appt has happened)
296,Provider14,Provider7,1519349400,1519353000,3600,Tutoring,Confirmed (Appt has happened)
297,Provider14,Provider7,1519689600,1519695000,5400,Tutoring,Confirmed (Appt has happened)
298,Provider14,Provider7,1519954200,1519957800,3600,Tutoring,Confirmed (Appt has happened)
299,Provider15,Provider15,1517355000,1517358600,3600,Ed. Therapy,Confirmed (Appt has happened)
300,Provider15,Provider58,1517423400,1517425200,1800,,
301,Provider15,Provider59,1517527800,1517531400,3600,Ed. Therapy,Confirmed (Appt has happened)
302,Provider15,Provider58,1517531400,1517535000,3600,Ed. Therapy,Confirmed (Appt has happened)
303,Provider15,Provider60,1517617800,1517621400,3600,Ed. Therapy,Cancelled (No charge not rescheduled)
304,Provider15,Provider15,1517959800,1517963400,3600,Ed. Therapy,Confirmed (Appt has happened)
305,Provider15,Provider61,1518046200,1518049800,3600,Ed. Therapy,Confirmed (Appt has happened)
306,Provider15,Provider59,1518132600,1518136200,3600,Ed. Therapy,Confirmed (Appt has happened)
307,Provider15,Provider58,1518136200,1518139800,3600,Ed. Therapy,Confirmed (Appt has happened)
308,Provider16,Provider19,1517356800,1517360400,3600,Ed. Therapy,Confirmed (Appt has happened)
309,Provider17,Provider62,1517527800,1517531400,3600,,Confirmed (Appt has happened)
310,Provider17,Provider63,1518042600,1518046200,3600,,Confirmed (Appt has happened)
311,Provider17,Provider64,1518735600,1518739200,3600,,Confirmed (Appt has happened)
312,Provider18,Provider65,1517248800,1517249700,900,Phone Call,Confirmed (Appt has happened)
313,Provider18,Provider66,1517259900,1517263500,3600,Ed. Therapy,Confirmed (Appt has happened)
314,Provider18,Provider67,1517263500,1517266800,3300,Ed. Therapy,Confirmed (Appt has happened)
315,Provider18,Provider68,1517272200,1517275800,3600,Ed. Therapy,Confirmed (Appt has happened)
316,Provider18,Provider69,1517275800,1517279400,3600,Ed. Therapy,Confirmed (Appt has happened)
317,Provider18,Provider70,1517328000,1517331600,3600,Ed. Therapy,Confirmed (Appt has happened)
318,Provider18,Provider66,1517349900,1517353200,3300,Ed. Therapy,Confirmed (Appt has happened)
319,Provider18,Provider71,1517355000,1517358600,3600,Ed. Therapy,Confirmed (Appt has happened)
320,Provider18,Provider72,1517362200,1517365800,3600,Ed. Therapy,Confirmed (Appt has happened)
321,Provider18,Provider70,1517416200,1517419800,3600,Ed. Therapy,Confirmed (Appt has happened)
322,Provider18,Provider73,1517419800,1517423100,3300,Ed. Therapy,Confirmed (Appt has happened)
323,Provider18,Provider74,1517437800,1517441400,3600,Ed. Therapy,Confirmed (Appt has happened)
324,Provider18,Provider75,1517448600,1517452200,3600,Ed. Therapy,Confirmed (Appt has happened)
325,Provider18,Provider76,1517527800,1517531400,3600,Ed. Therapy,Confirmed (Appt has happened)
326,Provider18,Provider74,1517531400,1517535000,3600,Ed. Therapy,Confirmed (Appt has happened)
327,Provider18,Provider77,1517535000,1517538600,3600,Ed. Therapy,Confirmed (Appt has happened)
328,Provider18,Provider73,1517587200,1517590800,3600,Ed. Therapy,Confirmed (Appt has happened)
329,Provider18,Provider67,1517590800,1517594400,3600,Ed. Therapy,Confirmed (Appt has happened)
330,Provider18,Provider65,1517595600,1517598900,3300,Ed. Therapy,Confirmed (Appt has happened)
331,Provider18,Provider74,1517598900,1517602200,3300,Ed. Therapy,Confirmed (Appt has happened)
332,Provider18,Provider78,1517614200,1517617800,3600,Ed. Therapy,Confirmed (Appt has happened)
333,Provider18,Provider68,1517617800,1517621400,3600,Ed. Therapy,Confirmed (Appt has happened)
334,Provider18,Provider75,1517850000,1517850900,900,Phone Call,Confirmed (Appt has happened)
335,Provider18,Provider66,1517864700,1517868300,3600,Ed. Therapy,Confirmed (Appt has happened)
336,Provider18,Provider67,1517868300,1517871600,3300,Ed. Therapy,Confirmed (Appt has happened)
337,Provider18,Provider68,1517877000,1517880600,3600,Ed. Therapy,Confirmed (Appt has happened)
338,Provider18,Provider69,1517880600,1517884200,3600,Ed. Therapy,Confirmed (Appt has happened)
339,Provider18,Provider70,1517932800,1517936400,3600,Ed. Therapy,Confirmed (Appt has happened)
340,Provider18,Provider66,1517951100,1517954700,3600,Ed. Therapy,Confirmed (Appt has happened)
341,Provider18,Provider75,1517967000,1517968800,1800,Administrative,Confirmed (Appt has happened)
342,Provider18,Provider70,1518021000,1518024600,3600,Ed. Therapy,Confirmed (Appt has happened)
343,Provider18,Provider73,1518024600,1518027900,3300,Ed. Therapy,Confirmed (Appt has happened)
344,Provider18,Provider74,1518046200,1518049800,3600,Ed. Therapy,Confirmed (Appt has happened)
345,Provider18,Provider75,1518053400,1518057000,3600,Ed. Therapy,Confirmed (Appt has happened)
346,Provider18,Provider76,1518132600,1518136200,3600,Ed. Therapy,Confirmed (Appt has happened)
347,Provider18,Provider73,1518192000,1518195600,3600,Ed. Therapy,Confirmed (Appt has happened)
348,Provider18,Provider67,1518195600,1518199200,3600,Ed. Therapy,Confirmed (Appt has happened)
349,Provider18,Provider65,1518200400,1518203700,3300,Ed. Therapy,Confirmed (Appt has happened)
350,Provider18,Provider74,1518203700,1518207000,3300,Ed. Therapy,Confirmed (Appt has happened)
351,Provider18,Provider78,1518219000,1518222600,3600,Ed. Therapy,Confirmed (Appt has happened)
352,Provider18,Provider68,1518222600,1518226200,3600,Ed. Therapy,Cancelled (No charge not rescheduled)
353,Provider18,Provider79,1518226200,1518229800,3600,Ed. Therapy,Confirmed (Appt has happened)
354,Provider18,Provider66,1518469500,1518473100,3600,Ed. Therapy,Confirmed (Appt has happened)
355,Provider18,Provider67,1518473100,1518476400,3300,Ed. Therapy,Confirmed (Appt has happened)
356,Provider18,Provider71,1518478200,1518481800,3600,Ed. Therapy,Confirmed (Appt has happened)
357,Provider18,Provider68,1518481800,1518485400,3600,Ed. Therapy,Confirmed (Appt has happened)
358,Provider18,Provider69,1518485400,1518489000,3600,Ed. Therapy,Confirmed (Appt has happened)
359,Provider18,Provider70,1518537600,1518541200,3600,Ed. Therapy,Confirmed (Appt has happened)
360,Provider18,Provider66,1518555900,1518559500,3600,Ed. Therapy,Cancelled (No charge not rescheduled)
361,Provider18,Provider73,1518624000,1518627600,3600,Ed. Therapy,Confirmed (Appt has happened)
362,Provider18,Provider70,1518627600,1518631200,3600,Ed. Therapy,Confirmed (Appt has happened)
363,Provider18,Provider74,1518647400,1518651000,3600,Ed. Therapy,Confirmed (Appt has happened)
364,Provider18,Provider59,1518651000,1518654600,3600,Ed. Therapy,Confirmed (Appt has happened)
365,Provider18,Provider75,1518658200,1518661800,3600,Ed. Therapy,Confirmed (Appt has happened)
366,Provider18,Provider76,1518738300,1518741900,3600,Ed. Therapy,Confirmed (Appt has happened)
367,Provider18,Provider77,1518744600,1518748200,3600,Ed. Therapy,Confirmed (Appt has happened)
368,Provider18,Provider73,1518796800,1518800400,3600,Ed. Therapy,Confirmed (Appt has happened)
369,Provider18,Provider67,1518800400,1518804000,3600,Ed. Therapy,Confirmed (Appt has happened)
370,Provider18,Provider65,1518805200,1518808500,3300,Ed. Therapy,Confirmed (Appt has happened)
371,Provider18,Provider74,1518808500,1518811800,3300,Ed. Therapy,Confirmed (Appt has happened)
372,Provider18,Provider78,1518823800,1518827400,3600,Ed. Therapy,Cancelled (No charge not rescheduled)
373,Provider18,Provider68,1518827400,1518831000,3600,Ed. Therapy,Confirmed (Appt has happened)
374,Provider18,Provider79,1518831000,1518834600,3600,Ed. Therapy,Confirmed (Appt has happened)
375,Provider18,Provider68,1519083000,1519086600,3600,Ed. Therapy,Confirmed (Appt has happened)
376,Provider18,Provider59,1519149600,1519153200,3600,Ed. Therapy,Scheduled
377,Provider18,Provider75,1519239600,1519243200,3600,Ed. Therapy,Scheduled
378,Provider18,Provider78,1519412400,1519416000,3600,Ed. Therapy,Scheduled
379,Provider18,Provider68,1519432200,1519435800,3600,Ed. Therapy,Scheduled
380,Provider18,Provider66,1519679100,1519682700,3600,Ed. Therapy,Confirmed (Appt has happened)
381,Provider18,Provider67,1519682700,1519686000,3300,Ed. Therapy,Confirmed (Appt has happened)
382,Provider18,Provider68,1519691400,1519695000,3600,Ed. Therapy,Confirmed (Appt has happened)
383,Provider18,Provider69,1519695000,1519698600,3600,Ed. Therapy,Confirmed (Appt has happened)
384,Provider18,Provider70,1519747200,1519750800,3600,Ed. Therapy,Scheduled
385,Provider18,Provider66,1519765500,1519769100,3600,Ed. Therapy,Confirmed (Appt has happened)
386,Provider18,Provider70,1519835400,1519839000,3600,Ed. Therapy,Scheduled
387,Provider18,Provider73,1519839000,1519842300,3300,Ed. Therapy,Scheduled
388,Provider18,Provider74,1519857000,1519860600,3600,Ed. Therapy,Scheduled
389,Provider18,Provider59,1519860600,1519864200,3600,Ed. Therapy,Confirmed (Appt has happened)
390,Provider18,Provider75,1519867800,1519871400,3600,Ed. Therapy,Confirmed (Appt has happened)
391,Provider18,Provider76,1519947900,1519951500,3600,Ed. Therapy,Scheduled
392,Provider18,Provider77,1519954200,1519957800,3600,Ed. Therapy,Scheduled
393,Provider18,Provider73,1520006400,1520010000,3600,Ed. Therapy,Scheduled
394,Provider18,Provider67,1520010000,1520013600,3600,Ed. Therapy,Scheduled
395,Provider18,Provider65,1520014800,1520018100,3300,Ed. Therapy,Scheduled
396,Provider18,Provider74,1520018100,1520021400,3300,Ed. Therapy,Scheduled
397,Provider18,Provider78,1520033400,1520037000,3600,Ed. Therapy,Scheduled
398,Provider18,Provider68,1520037000,1520040600,3600,Ed. Therapy,Scheduled
399,Provider18,Provider79,1520040600,1520044200,3600,Ed. Therapy,Scheduled
400,Provider19,Provider12,1517256000,1517265000,9000,Tutoring,Confirmed (Appt has happened)
401,Provider19,Provider80,1517266800,1517270400,3600,Study Hall,Confirmed (Appt has happened)
402,Provider19,Provider6,1517268600,1517272200,3600,Study Hall,Confirmed (Appt has happened)
403,Provider19,Provider12,1517335200,1517340600,5400,Tutoring,Confirmed (Appt has happened)
404,Provider19,Provider8,1517356800,1517360400,3600,Tutoring,Confirmed (Appt has happened)
405,Provider19,Provider81,1517360400,1517364000,3600,Tutoring,Confirmed (Appt has happened)
406,Provider19,Provider12,1517428800,1517437800,9000,Tutoring,Confirmed (Appt has happened)
407,Provider19,Provider82,1517439600,1517443200,3600,Tutoring,Confirmed (Appt has happened)
408,Provider19,Provider80,1517526000,1517529600,3600,Study Hall,Confirmed (Appt has happened)
409,Provider19,Provider6,1517529600,1517533200,3600,Study Hall,Confirmed (Appt has happened)
410,Provider19,Provider81,1517533200,1517536800,3600,Tutoring,Confirmed (Appt has happened)
411,Provider19,Provider4,1517594400,1517605200,10800,Tutoring,Confirmed (Appt has happened)
412,Provider19,Provider83,1517610600,1517616000,5400,Tutoring,Confirmed (Appt has happened)
413,Provider19,Provider12,1517860800,1517869800,9000,Tutoring,Confirmed (Appt has happened)
414,Provider19,Provider80,1517871600,1517875200,3600,Study Hall,Confirmed (Appt has happened)
415,Provider19,Provider6,1517873400,1517877000,3600,Study Hall,Confirmed (Appt has happened)
416,Provider19,Provider8,1517961600,1517965200,3600,Tutoring,Cancelled (w/out 24 hr notice charge)
417,Provider19,Provider81,1517965200,1517968800,3600,Tutoring,Cancelled (No charge not rescheduled)
418,Provider19,Provider12,1518033600,1518042600,9000,Tutoring,Confirmed (Appt has happened)
419,Provider19,Provider82,1518044400,1518048000,3600,Tutoring,Cancelled (w/out 24 hr notice charge)
420,Provider19,Provider80,1518130800,1518134400,3600,Study Hall,Confirmed (Appt has happened)
421,Provider19,Provider6,1518134400,1518138000,3600,Study Hall,Confirmed (Appt has happened)
422,Provider19,Provider81,1518138000,1518141600,3600,Tutoring,Confirmed (Appt has happened)
423,Provider19,Provider4,1518199200,1518210000,10800,Tutoring,Confirmed (Appt has happened)
424,Provider19,Provider83,1518215400,1518220800,5400,Tutoring,Confirmed (Appt has happened)
425,Provider19,Provider12,1518463800,1518474600,10800,Tutoring,Confirmed (Appt has happened)
426,Provider19,Provider80,1518476400,1518480000,3600,Study Hall,Confirmed (Appt has happened)
427,Provider19,Provider6,1518478200,1518481800,3600,Study Hall,Confirmed (Appt has happened)
428,Provider19,Provider8,1518566400,1518570000,3600,Tutoring,Confirmed (Appt has happened)
429,Provider19,Provider81,1518570000,1518573600,3600,Tutoring,Confirmed (Appt has happened)
430,Provider19,Provider12,1518638400,1518645600,7200,Tutoring,Confirmed (Appt has happened)
431,Provider19,Provider82,1518649200,1518652800,3600,Tutoring,Confirmed (Appt has happened)
432,Provider19,Provider12,1518726600,1518727500,900,Administrative,Confirmed (Appt has happened)
433,Provider19,Provider80,1518735600,1518739200,3600,Study Hall,Cancelled (w/out 24 hr notice charge)
434,Provider19,Provider6,1518737400,1518741000,3600,Study Hall,Confirmed (Appt has happened)
435,Provider19,Provider81,1518742800,1518746400,3600,Tutoring,Cancelled (No charge not rescheduled)
436,Provider19,Provider4,1518804000,1518814800,10800,Tutoring,Confirmed (Appt has happened)
437,Provider19,Provider12,1518816600,1518817500,900,Administrative,Confirmed (Appt has happened)
438,Provider19,Provider83,1518820200,1518825600,5400,Tutoring,Confirmed (Appt has happened)
439,Provider19,Provider12,1519070400,1519079400,9000,Tutoring,Confirmed (Appt has happened)
440,Provider19,Provider80,1519081200,1519084800,3600,Study Hall,Confirmed (Appt has happened)
441,Provider19,Provider6,1519083000,1519086600,3600,Study Hall,Confirmed (Appt has happened)
442,Provider19,Provider8,1519171200,1519174800,3600,Tutoring,Confirmed (Appt has happened)
443,Provider19,Provider81,1519174800,1519178400,3600,Tutoring,Confirmed (Appt has happened)
444,Provider19,Provider12,1519243200,1519252200,9000,Tutoring,Confirmed (Appt has happened)
445,Provider19,Provider82,1519254000,1519257600,3600,Tutoring,Confirmed (Appt has happened)
446,Provider19,Provider80,1519340400,1519344000,3600,Study Hall,Confirmed (Appt has happened)
447,Provider19,Provider6,1519344000,1519347600,3600,Study Hall,Confirmed (Appt has happened)
448,Provider19,Provider81,1519347600,1519351200,3600,Tutoring,Confirmed (Appt has happened)
449,Provider19,Provider4,1519408800,1519419600,10800,Tutoring,Confirmed (Appt has happened)
450,Provider19,Provider83,1519425000,1519430400,5400,Tutoring,Confirmed (Appt has happened)
451,Provider19,Provider12,1519675200,1519684200,9000,Tutoring,Confirmed (Appt has happened)
452,Provider19,Provider80,1519686000,1519689600,3600,Study Hall,Confirmed (Appt has happened)
453,Provider19,Provider6,1519687800,1519691400,3600,Study Hall,Confirmed (Appt has happened)
454,Provider19,Provider8,1519776000,1519779600,3600,Tutoring,Confirmed (Appt has happened)
455,Provider19,Provider81,1519779600,1519783200,3600,Tutoring,Confirmed (Appt has happened)
456,Provider19,Provider12,1519848000,1519857000,9000,Tutoring,Confirmed (Appt has happened)
457,Provider19,Provider82,1519858800,1519862400,3600,Tutoring,Confirmed (Appt has happened)
458,Provider19,Provider80,1519945200,1519948800,3600,Study Hall,Confirmed (Appt has happened)
459,Provider19,Provider6,1519948800,1519952400,3600,Study Hall,Confirmed (Appt has happened)
460,Provider19,Provider81,1519952400,1519956000,3600,Tutoring,Confirmed (Appt has happened)
461,Provider19,Provider4,1520013600,1520024400,10800,Tutoring,Confirmed (Appt has happened)
462,Provider19,Provider83,1520029800,1520035200,5400,Tutoring,Confirmed (Appt has happened)
463,Provider20,Provider84,1517261400,1517262300,900,Administrative,Confirmed (Appt has happened)
464,Provider20,Provider85,1517263200,1517266800,3600,Ed. Therapy,Confirmed (Appt has happened)
465,Provider20,Provider86,1517266800,1517268600,1800,Skype/GotoMeeting Appointment,Confirmed (Appt has happened)
466,Provider20,Provider87,1517268600,1517272200,3600,Ed. Therapy,Confirmed (Appt has happened)
467,Provider20,Provider88,1517272200,1517275800,3600,Ed. Therapy,Cancelled (No charge not rescheduled)
468,Provider20,Provider89,1517272200,1517275800,3600,Ed. Therapy,Confirmed (Appt has happened)
469,Provider20,Provider9,1517351400,1517355000,3600,Ed. Therapy,Confirmed (Appt has happened)
470,Provider20,Provider90,1517355000,1517358600,3600,Ed. Therapy,Confirmed (Appt has happened)
471,Provider20,Provider91,1517362200,1517364000,1800,Ed. Therapy,Confirmed (Appt has happened)
472,Provider20,Provider83,1517437800,1517441400,3600,Ed. Therapy,Confirmed (Appt has happened)
473,Provider20,Provider86,1517441400,1517444100,2700,Skype/GotoMeeting Appointment,Confirmed (Appt has happened)
474,Provider20,Provider92,1517445000,1517448600,3600,Ed. Therapy,Cancelled (No charge not rescheduled)
475,Provider20,Provider84,1517531400,1517535000,3600,Ed. Therapy,Cancelled (No charge not rescheduled)
476,Provider20,Provider93,1517535000,1517538600,3600,Ed. Therapy,Confirmed (Appt has happened)
477,Provider20,Provider84,1517607000,1517608800,1800,Administrative,Confirmed (Appt has happened)
478,Provider20,Provider94,1517612400,1517616000,3600,Ed. Therapy,Confirmed (Appt has happened)
479,Provider20,Provider95,1517617800,1517621400,3600,Skype/GotoMeeting Appointment,Confirmed (Appt has happened)
480,Provider20,Provider85,1517868000,1517871600,3600,Ed. Therapy,Confirmed (Appt has happened)
481,Provider20,Provider87,1517873400,1517877000,3600,Ed. Therapy,Confirmed (Appt has happened)
482,Provider20,Provider88,1517877000,1517880600,3600,Ed. Therapy,Confirmed (Appt has happened)
483,Provider20,Provider96,1517880600,1517884200,3600,Ed. Therapy,Confirmed (Appt has happened)
484,Provider20,Provider9,1517956200,1517959800,3600,Ed. Therapy,Confirmed (Appt has happened)
485,Provider20,Provider90,1517959800,1517963400,3600,Ed. Therapy,Confirmed (Appt has happened)
486,Provider20,Provider92,1517963400,1517967000,3600,Ed. Therapy,Confirmed (Appt has happened)
487,Provider20,Provider83,1518042600,1518046200,3600,Ed. Therapy,Confirmed (Appt has happened)
488,Provider20,Provider86,1518046200,1518049800,3600,Skype/GotoMeeting Appointment,Confirmed (Appt has happened)
489,Provider20,Provider97,1518049800,1518053400,3600,Ed. Therapy,Confirmed (Appt has happened)
490,Provider20,Provider95,1518053400,1518057000,3600,Ed. Therapy,Confirmed (Appt has happened)
491,Provider20,Provider85,1518127200,1518130800,3600,Ed. Therapy,Cancelled (No charge not rescheduled)
492,Provider20,Provider84,1518136200,1518139800,3600,Ed. Therapy,Confirmed (Appt has happened)
493,Provider20,Provider93,1518139800,1518143400,3600,Ed. Therapy,Confirmed (Appt has happened)
494,Provider20,Provider94,1518215400,1518219000,3600,Ed. Therapy,Confirmed (Appt has happened)
495,Provider20,Provider89,1518224400,1518228000,3600,Ed. Therapy,Cancelled (No charge not rescheduled)
496,Provider20,Provider83,1518381900,1518390000,8100,Ed. Therapy,Confirmed (Appt has happened)
497,Provider20,Provider83,1518478200,1518480000,1800,Ed. Therapy,Confirmed (Appt has happened)
498,Provider20,Provider88,1518481800,1518485400,3600,Ed. Therapy,Confirmed (Appt has happened)
499,Provider20,Provider9,1518561000,1518564600,3600,Ed. Therapy,Confirmed (Appt has happened)
500,Provider20,Provider90,1518564600,1518568200,3600,Ed. Therapy,Confirmed (Appt has happened)
501,Provider20,Provider93,1518568200,1518571800,3600,Ed. Therapy,Confirmed (Appt has happened)
502,Provider20,Provider95,1518622200,1518624000,1800,Administrative,Confirmed (Appt has happened)
503,Provider20,Provider95,1518624000,1518629400,5400,School Meeting,Confirmed (Appt has happened)
504,Provider20,Provider95,1518629400,1518630300,900,Administrative,Confirmed (Appt has happened)
505,Provider20,Provider83,1518647400,1518651000,3600,Ed. Therapy,Confirmed (Appt has happened)
506,Provider20,Provider86,1518651000,1518654600,3600,Skype/GotoMeeting Appointment,Confirmed (Appt has happened)
507,Provider20,Provider85,1518732000,1518735600,3600,Ed. Therapy,Confirmed (Appt has happened)
508,Provider20,Provider98,1518735600,1518739200,3600,Ed. Therapy,Confirmed (Appt has happened)
509,Provider20,Provider87,1518741000,1518744600,3600,Ed. Therapy,Confirmed (Appt has happened)
510,Provider20,Provider84,1518741000,1518744600,3600,Ed. Therapy,Cancelled (No charge not rescheduled)
511,Provider20,Provider95,1518744600,1518748200,3600,Ed. Therapy,Confirmed (Appt has happened)
512,Provider20,Provider94,1518820200,1518823800,3600,Ed. Therapy,Confirmed (Appt has happened)
513,Provider20,Provider96,1519090200,1519093800,3600,Ed. Therapy,Cancelled (No charge not rescheduled)
514,Provider20,Provider9,1519165800,1519169400,3600,Ed. Therapy,Scheduled
515,Provider20,Provider90,1519169400,1519173000,3600,Ed. Therapy,Confirmed (Appt has happened)
516,Provider20,Provider92,1519173000,1519176600,3600,Ed. Therapy,Confirmed (Appt has happened)
517,Provider20,Provider93,1519176600,1519180200,3600,Ed. Therapy,Confirmed (Appt has happened)
518,Provider20,Provider83,1519252200,1519255800,3600,Ed. Therapy,Confirmed (Appt has happened)
519,Provider20,Provider86,1519255800,1519259400,3600,Skype/GotoMeeting Appointment,Confirmed (Appt has happened)
520,Provider20,Provider97,1519259400,1519263000,3600,Ed. Therapy,Confirmed (Appt has happened)
521,Provider20,Provider95,1519263000,1519266600,3600,Ed. Therapy,Confirmed (Appt has happened)
522,Provider20,Provider85,1519336800,1519340400,3600,Ed. Therapy,Scheduled
523,Provider20,Provider87,1519340400,1519344000,3600,Ed. Therapy,Confirmed (Appt has happened)
524,Provider20,Provider88,1519345800,1519349400,3600,Ed. Therapy,Scheduled
525,Provider20,Provider84,1519345800,1519349400,3600,Ed. Therapy,Cancelled (No charge not rescheduled)
526,Provider20,Provider89,1519434000,1519437600,3600,Ed. Therapy,Cancelled (No charge not rescheduled)
527,Provider20,Provider98,1519684200,1519687800,3600,Ed. Therapy,Confirmed (Appt has happened)
528,Provider20,Provider94,1519687800,1519691400,3600,Ed. Therapy,Scheduled
529,Provider20,Provider88,1519691400,1519695000,3600,Ed. Therapy,Confirmed (Appt has happened)
530,Provider20,Provider96,1519695000,1519698600,3600,Ed. Therapy,Scheduled
531,Provider20,Provider9,1519770600,1519774200,3600,Ed. Therapy,Scheduled
532,Provider20,Provider90,1519774200,1519777800,3600,Ed. Therapy,Confirmed (Appt has happened)
533,Provider20,Provider92,1519777800,1519781400,3600,Ed. Therapy,Confirmed (Appt has happened)
534,Provider20,Provider93,1519781400,1519785000,3600,Ed. Therapy,Confirmed (Appt has happened)
535,Provider20,Provider83,1519857000,1519860600,3600,Ed. Therapy,Confirmed (Appt has happened)
536,Provider20,Provider86,1519860600,1519864200,3600,Skype/GotoMeeting Appointment,Confirmed (Appt has happened)
537,Provider20,Provider99,1519864200,1519867800,3600,Ed. Therapy,Confirmed (Appt has happened)
538,Provider20,Provider95,1519867800,1519871400,3600,Ed. Therapy,Confirmed (Appt has happened)
539,Provider20,Provider85,1519941600,1519945200,3600,Ed. Therapy,Scheduled
540,Provider20,Provider87,1519945200,1519948800,3600,Ed. Therapy,Confirmed (Appt has happened)
541,Provider20,Provider84,1519950600,1519954200,3600,Ed. Therapy,Cancelled (No charge not rescheduled)
542,Provider20,Provider94,1520029800,1520033400,3600,Ed. Therapy,Scheduled
543,Provider20,Provider89,1520038800,1520042400,3600,Ed. Therapy,Cancelled (No charge not rescheduled)
